%%%%%%%%%%%%%%%%%%%%%%%%%%%%%%%%%%%%%
%                                   %
%%%%%%%%%%%%%%%%%%%%%%%%%%%%%%%%%%% %                                   %
%                                   %
% %%%%%%%%%%%%%%%%%%%%%%%%%%%%%%%%%%%                                  %
%                                   %
%%%%%%%%%%%%%%%%%%%%%%%%%%%%%%%%%%% %                                  %
%     .                             %
% %%%%%%%%%%%%%%%%%%%%%%%%%%%%%%%%%%%                                  %
%                                  P%
%%%%%%%%%%%%%%%%%%%%%%%%%%%%%%%%%%%%%